TILEMAP
36 28 							-- Size of tile map in tiles
16 16 							-- Tile size & block size
images/Materials_sheet.png 	-- Tilesheet
16 16								-- Number of tiles in tilesheet
222222222222222222222222222222222222
2                                  2
2                                  2
2                                  2
2                                  2
2                                  2
2                                  2
2                                  2
2                                  2
2     111111111111111111111111     2
2     1                      1     2
2     1                      1     2
2     1                      1     2
2     1                      1     2
2     1                      1     2
2     1  111111111111111111111     2
2                                  2
2                                  2
2                                  2
2                                  2
2                                  2
2                                  2
2                                  2
2                                  2
2                                  2
2                                  2
2                                  2
222222222222222222222222222222222222

